##########################
#          #  #          #
#          #  #          #
#          #  #          #
#          #  #          #
#          #  #          #
#                        #
#          #  #          #
#          #  #          #
#          #  #          #
#          #  #          #
############  #############
#          #  #          #
#          #  #          #
#          #  #          #
#          #  #          #
#          #  #          #
#                        #
#          #  #          #
#          #  #          #
#          #  #          #
#          #  #          #
############  ############
#          #  #          #
#          #  #          #
#          #  #          #
#          #  #          #
#          #  #          #
#                        #
#          #  #          #
#          #  #          #
#          #  #          #
#          #  #          #
##########################
